columnas,count,unique,duplicate,vacios,cero,null,unique_values
ï»¿cla_event_no,69,10,59,0,0,0,"[1643, 1842, 1822, 1783, 1823, 1702, 1862, 1922, 1903, 1742]"
cla_case_no,69,10,59,0,0,0,"[1723, 1902, 1882, 1843, 1883, 1762, 1922, 1982, 1963, 1802]"
cla_subcase_no,0,0,0,0,0,69,[nan]
cla_item_no,69,19,50,0,0,0,"[1439, 1438, 1622, 1623, 1603, 1545, 1605, 1604, 1482, 1483, 1642, 1643, 1703, 1702, 1687, 1502, 1503, 1602, 1562]"
seq_no,69,69,0,0,0,0,"[1680, 1682, 1679, 1681, 2045, 2043, 2044, 1963, 1964, 1846, 2025, 2024, 2026, 2023, 1745, 1743, 1744, 2063, 2065, 2064, 2129, 2134, 2190, 2189, 2191, 2114, 1703, 1783, 1784, 2171, 2172, 1765, 1764, 1763, 1766, 1767, 1883, 1884, 1731, 1732, 1924, 1923, 1925, 1928, 1926, 1927, 1805, 1803, 1804, 1983, 1984, 2083, 2085, 2086, 2088, 2087, 2084, 2074, 1944, 1946, 1943, 1866, 1865, 1863, 1867, 1868, 1864, 2003, 2004]"
description,66,3,63,0,0,3,"['Reserva Automatica', 'Honorarios para el liquidador', 'Automatic Item', nan]"
receiver_id_no,25,5,20,0,0,44,"[nan, 71552.0, 85286.0, 85251.0, 89052.0, 89346.0]"
object_no,69,10,59,0,0,0,"[53475, 53755, 53936, 53937, 54015, 52793, 53979, 55779, 55735, 54359]"
object_seq_no,69,10,59,0,0,0,"[77207, 77573, 77792, 77793, 77870, 76524, 77834, 79717, 79674, 78235]"
object_id,28,4,24,0,0,41,"[nan, 77573.0, 76524.0, 77834.0, 79674.0]"
object_price,0,0,0,0,0,69,[nan]
object_age,0,0,0,0,0,69,[nan]
risk_no,69,5,64,0,0,0,"[201, 401, 301, 501, 505]"
subrisk_no,69,1,68,0,0,0,[0]
status,69,3,66,0,0,0,"['OP', 'CL', 'RO']"
first_open_date,69,11,58,0,0,0,"['2023-06-02 12:49:52.000000 UTC', '2023-09-21 16:35:37.000000 UTC', '2023-08-25 15:09:45.000000 UTC', '2023-07-21 15:56:36.000000 UTC', '2023-08-25 16:05:35.000000 UTC', '2023-06-16 17:11:43.000000 UTC', '2023-09-26 14:51:18.000000 UTC', '2023-11-23 13:59:37.000000 UTC', '2023-10-30 13:22:17.000000 UTC', '2023-07-17 12:50:19.000000 UTC', '2023-08-09 15:46:47.000000 UTC']"
first_close_date,20,15,5,0,0,49,"[nan, '2023-08-30 09:14:25.000000 UTC', '2023-09-19 14:55:48.000000 UTC', '2023-09-19 14:48:03.000000 UTC', '2023-06-05 11:13:10.000000 UTC', '2023-06-21 15:08:52.000000 UTC', '2023-06-21 15:08:37.000000 UTC', '2023-11-16 15:19:59.000000 UTC', '2023-06-15 13:37:55.000000 UTC', '2023-08-31 12:04:09.000000 UTC', '2023-10-10 10:47:17.000000 UTC', '2023-10-10 10:49:50.000000 UTC', '2023-08-28 16:14:02.000000 UTC', '2023-08-09 16:03:44.000000 UTC', '2023-08-09 16:03:45.000000 UTC', '2023-09-13 16:49:06.000000 UTC']"
reopen_date,5,2,3,0,0,64,"[nan, '2023-06-21 15:49:09.000000 UTC', '2023-06-21 15:49:26.000000 UTC']"
reopen_reason,0,0,0,0,0,69,[nan]
reclose_date,2,2,0,0,0,67,"[nan, '2023-07-10 15:40:30.000000 UTC', '2023-07-10 15:41:19.000000 UTC']"
hours_spend,0,0,0,0,0,69,[nan]
workgroup,0,0,0,0,0,69,[nan]
handler,69,4,65,0,0,0,"['OLIVET', 'ESTFRANC', 'ESTUSSGG', 'ESTSALVA']"
estimate_date,69,55,14,0,0,0,"['2023-06-02 12:49:52.000000 UTC', '2023-06-02 14:45:54.000000 UTC', '2023-09-21 16:35:41.000000 UTC', '2023-09-21 16:35:39.000000 UTC', '2023-09-21 16:35:40.000000 UTC', '2023-08-30 09:14:24.000000 UTC', '2023-08-30 09:14:25.000000 UTC', '2023-07-21 15:56:36.000000 UTC', '2023-09-19 14:55:48.000000 UTC', '2023-09-19 14:51:09.000000 UTC', '2023-09-19 14:48:03.000000 UTC', '2023-06-16 17:11:46.000000 UTC', '2023-06-16 17:11:45.000000 UTC', '2023-09-26 14:51:19.000000 UTC', '2023-09-26 14:51:21.000000 UTC', '2023-09-26 14:51:20.000000 UTC', '2023-11-03 17:25:26.000000 UTC', '2023-11-03 17:31:20.000000 UTC', '2023-11-23 13:59:39.000000 UTC', '2023-11-23 13:59:38.000000 UTC', '2023-11-23 13:59:40.000000 UTC', '2023-10-30 13:22:17.000000 UTC', '2023-06-05 11:13:10.000000 UTC', '2023-07-10 15:40:31.000000 UTC', '2023-07-10 15:41:19.000000 UTC', '2023-11-16 15:19:59.000000 UTC', '2023-06-21 15:49:09.000000 UTC', '2023-06-21 15:08:52.000000 UTC', '2023-06-21 15:08:37.000000 UTC', '2023-06-21 15:49:26.000000 UTC', '2023-06-21 15:49:41.000000 UTC', '2023-08-17 10:45:03.000000 UTC', '2023-08-17 10:45:28.000000 UTC', '2023-06-15 13:37:55.000000 UTC', '2023-08-25 15:09:48.000000 UTC', '2023-08-25 15:09:46.000000 UTC', '2023-08-25 15:09:49.000000 UTC', '2023-08-25 16:05:35.000000 UTC', '2023-07-17 12:50:22.000000 UTC', '2023-07-17 12:50:20.000000 UTC', '2023-07-17 12:50:21.000000 UTC', '2023-08-31 12:04:09.000000 UTC', '2023-10-10 10:17:57.000000 UTC', '2023-10-10 10:47:17.000000 UTC', '2023-10-10 10:49:50.000000 UTC', '2023-10-10 10:24:19.000000 UTC', '2023-09-27 15:19:19.000000 UTC', '2023-08-28 16:14:02.000000 UTC', '2023-08-28 16:20:18.000000 UTC', '2023-08-28 16:12:25.000000 UTC', '2023-08-09 16:03:44.000000 UTC', '2023-08-09 15:45:32.000000 UTC', '2023-08-09 16:03:45.000000 UTC', '2023-08-09 15:45:38.000000 UTC', '2023-09-13 16:49:06.000000 UTC']"
newest,69,2,67,0,0,0,"['N', 'Y']"
stat_code1,0,0,0,0,0,69,[nan]
stat_code2,0,0,0,0,0,69,[nan]
stat_code3,0,0,0,0,0,69,[nan]
item_type,69,2,67,0,0,0,"['RE', 'CO']"
subitem_type,69,5,64,0,0,0,"[23, 39, 27, 18, 28]"
currency_code,69,1,68,0,0,0,['ARS']
currency_estimate,69,18,51,0,0,0,"[18000, 150000, 100, 14900, 0, 22500, 187550, 12100, 10000, 3800, 50, 10800, 60000, 16200, 99800, 101000, 200000, 20000]"
estimate,69,18,51,0,0,0,"[18000, 150000, 100, 14900, 0, 22500, 187550, 12100, 10000, 3800, 50, 10800, 60000, 16200, 99800, 101000, 200000, 20000]"
currency_diff,69,31,38,0,0,0,"[18000, 132000, 100, 0, 14900, -99800, 22500, -187550, 172650, -100, 12000, -2100, 3800, -50, -10000, -18000, 50, 10700, 37500, -150000, -60000, 16100, -16200, 127500, -1200, 97200, -200000, 177500, -20000, 20000, -10800]"
diff,69,31,38,0,0,0,"[18000, 132000, 100, 0, 14900, -99800, 22500, -187550, 172650, -100, 12000, -2100, 3800, -50, -10000, -18000, 50, 10700, 37500, -150000, -60000, 16100, -16200, 127500, -1200, 97200, -200000, 177500, -20000, 20000, -10800]"
exchange_rate,69,1,68,0,0,0,[100]
authorised_by,18,5,13,0,0,51,"[nan, 'LOCONSOV', 'CLAVIO', 'FRANCISC', 'BENITEGL', 'RAGONESE']"
gl_batch_no,57,20,37,0,0,12,"[384.0, 533.0, nan, 480.0, 0.0, 531.0, 398.0, 538.0, 588.0, 608.0, 583.0, 387.0, 601.0, 403.0, 467.0, 397.0, 475.0, 481.0, 563.0, 478.0, 526.0]"
pay,3,1,2,0,0,66,"[nan, 'N']"
timestamp,69,59,10,0,0,0,"['2023-06-02 12:49:52.000000 UTC', '2023-06-02 14:45:54.000000 UTC', '2023-06-02 12:49:58.000000 UTC', '2023-09-21 16:35:47.000000 UTC', '2023-09-21 16:35:39.000000 UTC', '2023-09-21 16:35:41.000000 UTC', '2023-08-30 09:14:24.000000 UTC', '2023-08-30 09:14:25.000000 UTC', '2023-07-21 15:56:36.000000 UTC', '2023-09-19 14:55:48.000000 UTC', '2023-09-19 14:51:09.000000 UTC', '2023-09-19 14:48:10.000000 UTC', '2023-06-16 17:11:54.000000 UTC', '2023-06-16 17:11:45.000000 UTC', '2023-06-16 17:11:46.000000 UTC', '2023-09-26 14:51:19.000000 UTC', '2023-09-26 14:51:26.000000 UTC', '2023-09-26 14:51:20.000000 UTC', '2023-11-03 17:25:31.000000 UTC', '2023-11-03 17:31:20.000000 UTC', '2023-11-23 13:59:40.000000 UTC', '2023-11-23 13:59:38.000000 UTC', '2023-11-23 13:59:45.000000 UTC', '2023-10-30 13:22:18.000000 UTC', '2023-06-05 11:13:17.000000 UTC', '2023-07-10 15:40:37.000000 UTC', '2023-07-10 15:41:19.000000 UTC', '2023-11-16 15:19:59.000000 UTC', '2023-06-21 15:49:09.000000 UTC', '2023-06-21 15:08:58.000000 UTC', '2023-06-21 15:08:37.000000 UTC', '2023-06-21 15:49:26.000000 UTC', '2023-06-21 15:49:41.000000 UTC', '2023-08-17 10:45:10.000000 UTC', '2023-08-17 10:45:28.000000 UTC', '2023-06-15 13:37:55.000000 UTC', '2023-08-25 15:09:48.000000 UTC', '2023-08-25 15:09:47.000000 UTC', '2023-08-25 15:09:56.000000 UTC', '2023-08-25 16:05:35.000000 UTC', '2023-07-17 12:50:28.000000 UTC', '2023-07-17 12:50:20.000000 UTC', '2023-07-17 12:50:22.000000 UTC', '2023-08-31 12:04:09.000000 UTC', '2023-08-31 12:04:10.000000 UTC', '2023-10-10 10:18:03.000000 UTC', '2023-10-10 10:47:17.000000 UTC', '2023-10-10 10:49:50.000000 UTC', '2023-10-10 10:24:19.000000 UTC', '2023-09-27 15:19:19.000000 UTC', '2023-08-28 16:14:08.000000 UTC', '2023-08-28 16:20:18.000000 UTC', '2023-08-28 16:12:25.000000 UTC', '2023-08-09 16:03:44.000000 UTC', '2023-08-09 15:45:32.000000 UTC', '2023-08-09 16:03:45.000000 UTC', '2023-08-09 15:46:47.000000 UTC', '2023-09-13 16:49:06.000000 UTC', '2023-09-13 16:49:11.000000 UTC']"
userid,69,9,60,0,0,0,"['OLIVET', 'LOCONSOV', 'GARYULO', 'FRANCISC', 'BENITEGL', 'ZABALETY', 'BUCHICAR', 'RAGONESE', 'CLAVIO']"
role,25,1,24,0,0,44,"[nan, 20.0]"
record_version,69,5,64,0,0,0,"[4, 3, 6, 1, 2]"
suppress_reinsurance,0,0,0,0,0,69,[nan]
object_percent,0,0,0,0,0,69,[nan]
item_start_date,0,0,0,0,0,69,[nan]
item_end_date,0,0,0,0,0,69,[nan]
c01,0,0,0,0,0,69,[nan]
c02,0,0,0,0,0,69,[nan]
c03,0,0,0,0,0,69,[nan]
c04,0,0,0,0,0,69,[nan]
c05,0,0,0,0,0,69,[nan]
c06,0,0,0,0,0,69,[nan]
c07,0,0,0,0,0,69,[nan]
c08,0,0,0,0,0,69,[nan]
c09,0,0,0,0,0,69,[nan]
c10,0,0,0,0,0,69,[nan]
n01,0,0,0,0,0,69,[nan]
n02,0,0,0,0,0,69,[nan]
n03,0,0,0,0,0,69,[nan]
n04,0,0,0,0,0,69,[nan]
n05,0,0,0,0,0,69,[nan]
n06,0,0,0,0,0,69,[nan]
n07,0,0,0,0,0,69,[nan]
n08,0,0,0,0,0,69,[nan]
n09,0,0,0,0,0,69,[nan]
n10,0,0,0,0,0,69,[nan]
d01,0,0,0,0,0,69,[nan]
d02,0,0,0,0,0,69,[nan]
d03,0,0,0,0,0,69,[nan]
d04,0,0,0,0,0,69,[nan]
d05,0,0,0,0,0,69,[nan]
d06,0,0,0,0,0,69,[nan]
d07,0,0,0,0,0,69,[nan]
d08,0,0,0,0,0,69,[nan]
d09,0,0,0,0,0,69,[nan]
d10,0,0,0,0,0,69,[nan]
trans_date,69,50,19,0,0,0,"['2023-06-02 12:49:52.000000 UTC', '2023-06-02 14:45:54.000000 UTC', '2023-09-21 16:35:41.000000 UTC', '2023-09-21 16:35:40.000000 UTC', '2023-08-30 09:14:24.000000 UTC', '2023-08-30 09:14:25.000000 UTC', '2023-07-21 15:56:36.000000 UTC', '2023-09-19 14:55:48.000000 UTC', '2023-09-19 14:51:09.000000 UTC', '2023-09-19 14:48:03.000000 UTC', '2023-06-16 17:11:46.000000 UTC', '2023-09-26 14:51:19.000000 UTC', '2023-09-26 14:51:21.000000 UTC', '2023-09-26 14:51:20.000000 UTC', '2023-11-03 17:25:26.000000 UTC', '2023-11-03 17:31:20.000000 UTC', '2023-11-23 13:59:39.000000 UTC', '2023-11-23 13:59:40.000000 UTC', '2023-10-30 13:22:17.000000 UTC', '2023-06-05 11:13:10.000000 UTC', '2023-07-10 15:40:31.000000 UTC', '2023-07-10 15:41:19.000000 UTC', '2023-11-16 15:19:59.000000 UTC', '2023-06-21 15:49:09.000000 UTC', '2023-06-21 15:08:52.000000 UTC', '2023-06-21 15:08:37.000000 UTC', '2023-06-21 15:49:26.000000 UTC', '2023-06-21 15:49:41.000000 UTC', '2023-08-17 10:45:03.000000 UTC', '2023-08-17 10:45:28.000000 UTC', '2023-06-15 13:37:55.000000 UTC', '2023-08-25 15:09:48.000000 UTC', '2023-08-25 15:09:49.000000 UTC', '2023-08-25 16:05:35.000000 UTC', '2023-07-17 12:50:22.000000 UTC', '2023-07-17 12:50:21.000000 UTC', '2023-08-31 12:04:09.000000 UTC', '2023-10-10 10:17:57.000000 UTC', '2023-10-10 10:47:17.000000 UTC', '2023-10-10 10:49:50.000000 UTC', '2023-10-10 10:24:19.000000 UTC', '2023-09-27 15:19:19.000000 UTC', '2023-08-28 16:14:02.000000 UTC', '2023-08-28 16:20:18.000000 UTC', '2023-08-28 16:12:25.000000 UTC', '2023-08-09 16:03:44.000000 UTC', '2023-08-09 15:45:32.000000 UTC', '2023-08-09 16:03:45.000000 UTC', '2023-08-09 15:45:38.000000 UTC', '2023-09-13 16:49:06.000000 UTC']"
acc_interest_method,0,0,0,0,0,69,[nan]
document_date,0,0,0,0,0,69,[nan]
record_userid,69,8,61,0,0,0,"['GRIMALDI', 'LOCONSOV', 'OLIVET', 'FRANCISC', 'BENITEGL', 'RAGONESE', 'CLAVIO', 'GARYULO']"
record_timestamp,69,37,32,0,0,0,"['2023-06-02 22:30:10.000000 UTC', '2023-09-21 22:30:15.000000 UTC', '2023-09-21 16:35:47.000000 UTC', '2023-09-21 16:35:41.000000 UTC', '2023-08-30 22:30:16.000000 UTC', '2023-07-21 15:56:36.000000 UTC', '2023-09-19 22:30:16.000000 UTC', '2023-09-19 22:30:15.000000 UTC', '2023-06-16 22:30:10.000000 UTC', '2023-06-16 17:11:54.000000 UTC', '2023-06-16 17:11:46.000000 UTC', '2023-09-26 22:30:15.000000 UTC', '2023-11-03 22:30:17.000000 UTC', '2023-11-23 13:59:40.000000 UTC', '2023-11-23 13:59:45.000000 UTC', '2023-11-23 22:30:16.000000 UTC', '2023-10-30 22:30:16.000000 UTC', '2023-06-05 22:30:10.000000 UTC', '2023-07-10 15:40:37.000000 UTC', '2023-07-10 15:41:19.000000 UTC', '2023-11-16 22:30:16.000000 UTC', '2023-06-21 22:30:10.000000 UTC', '2023-08-17 22:30:16.000000 UTC', '2023-06-15 22:30:11.000000 UTC', '2023-08-25 15:09:48.000000 UTC', '2023-08-25 15:09:56.000000 UTC', '2023-08-25 22:30:15.000000 UTC', '2023-08-25 16:05:35.000000 UTC', '2023-07-17 12:50:28.000000 UTC', '2023-07-17 12:50:22.000000 UTC', '2023-08-31 22:30:16.000000 UTC', '2023-10-10 22:34:16.000000 UTC', '2023-09-27 15:19:19.000000 UTC', '2023-08-28 22:30:16.000000 UTC', '2023-08-09 16:03:44.000000 UTC', '2023-08-09 16:03:45.000000 UTC', '2023-09-13 22:30:15.000000 UTC']"
policy_line_seq_no,69,10,59,0,0,0,"[79946, 80332, 80551, 80552, 80629, 79263, 80593, 82498, 82453, 81014]"
uix_seq_no,69,69,0,0,0,0,"[2549461357, 2550370957, 2549461099, 2549461536, 3903927873, 3903925066, 3903927870, 3616957343, 3616957357, 3123071773, 3872461402, 3872420727, 3872461403, 3872394526, 2708836356, 2708836323, 2708836353, 3965998968, 3966000622, 3966000452, 4457926448, 4457985250, 4732814336, 4732813020, 4732815863, 4401597248, 2582307870, 2989423627, 2989430058, 4643504654, 4643504677, 2764210548, 2763894547, 2763891980, 2764213126, 2764215698, 3454126425, 3454129347, 2695867472, 2695867537, 3556778251, 3556778245, 3556778254, 3557292557, 3557292547, 3557292553, 3072889260, 3072889251, 3072889257, 3631155944, 3631155945, 4142481267, 4142742840, 4142742841, 4142766827, 4142766826, 4142540486, 3978949303, 3595136630, 3595188971, 3595122165, 3356559898, 3356559897, 3356401783, 3356559900, 3356559901, 3356404610, 3797842422, 3797842423]"
site_seq_no,69,1,68,0,0,0,[1]
c11,0,0,0,0,0,69,[nan]
c12,0,0,0,0,0,69,[nan]
c13,0,0,0,0,0,69,[nan]
c14,0,0,0,0,0,69,[nan]
c15,0,0,0,0,0,69,[nan]
c16,0,0,0,0,0,69,[nan]
c17,0,0,0,0,0,69,[nan]
c18,0,0,0,0,0,69,[nan]
c19,0,0,0,0,0,69,[nan]
c20,0,0,0,0,0,69,[nan]
c21,0,0,0,0,0,69,[nan]
c22,0,0,0,0,0,69,[nan]
c23,0,0,0,0,0,69,[nan]
c24,0,0,0,0,0,69,[nan]
c25,0,0,0,0,0,69,[nan]
c26,0,0,0,0,0,69,[nan]
c27,0,0,0,0,0,69,[nan]
c28,0,0,0,0,0,69,[nan]
c29,0,0,0,0,0,69,[nan]
c30,0,0,0,0,0,69,[nan]
c31,0,0,0,0,0,69,[nan]
c32,0,0,0,0,0,69,[nan]
c33,0,0,0,0,0,69,[nan]
c34,0,0,0,0,0,69,[nan]
c35,0,0,0,0,0,69,[nan]
c36,0,0,0,0,0,69,[nan]
c37,0,0,0,0,0,69,[nan]
c38,0,0,0,0,0,69,[nan]
c39,0,0,0,0,0,69,[nan]
c40,0,0,0,0,0,69,[nan]
c41,0,0,0,0,0,69,[nan]
c42,0,0,0,0,0,69,[nan]
c43,0,0,0,0,0,69,[nan]
c44,0,0,0,0,0,69,[nan]
c45,0,0,0,0,0,69,[nan]
c46,0,0,0,0,0,69,[nan]
c47,0,0,0,0,0,69,[nan]
c48,0,0,0,0,0,69,[nan]
c49,0,0,0,0,0,69,[nan]
c50,0,0,0,0,0,69,[nan]
n11,0,0,0,0,0,69,[nan]
n12,0,0,0,0,0,69,[nan]
n13,0,0,0,0,0,69,[nan]
n14,0,0,0,0,0,69,[nan]
n15,0,0,0,0,0,69,[nan]
n16,0,0,0,0,0,69,[nan]
n17,0,0,0,0,0,69,[nan]
n18,0,0,0,0,0,69,[nan]
n19,0,0,0,0,0,69,[nan]
n20,0,0,0,0,0,69,[nan]
n21,0,0,0,0,0,69,[nan]
n22,0,0,0,0,0,69,[nan]
n23,0,0,0,0,0,69,[nan]
n24,0,0,0,0,0,69,[nan]
n25,0,0,0,0,0,69,[nan]
n26,0,0,0,0,0,69,[nan]
n27,0,0,0,0,0,69,[nan]
n28,0,0,0,0,0,69,[nan]
n29,0,0,0,0,0,69,[nan]
n30,0,0,0,0,0,69,[nan]
n31,0,0,0,0,0,69,[nan]
n32,0,0,0,0,0,69,[nan]
n33,0,0,0,0,0,69,[nan]
n34,0,0,0,0,0,69,[nan]
n35,0,0,0,0,0,69,[nan]
n36,0,0,0,0,0,69,[nan]
n37,0,0,0,0,0,69,[nan]
n38,0,0,0,0,0,69,[nan]
n39,0,0,0,0,0,69,[nan]
n40,0,0,0,0,0,69,[nan]
n41,0,0,0,0,0,69,[nan]
n42,0,0,0,0,0,69,[nan]
n43,0,0,0,0,0,69,[nan]
n44,0,0,0,0,0,69,[nan]
n45,0,0,0,0,0,69,[nan]
n46,0,0,0,0,0,69,[nan]
n47,0,0,0,0,0,69,[nan]
n48,0,0,0,0,0,69,[nan]
n49,0,0,0,0,0,69,[nan]
n50,0,0,0,0,0,69,[nan]
d11,0,0,0,0,0,69,[nan]
d12,0,0,0,0,0,69,[nan]
d13,0,0,0,0,0,69,[nan]
d14,0,0,0,0,0,69,[nan]
d15,0,0,0,0,0,69,[nan]
d16,0,0,0,0,0,69,[nan]
d17,0,0,0,0,0,69,[nan]
d18,0,0,0,0,0,69,[nan]
d19,0,0,0,0,0,69,[nan]
d20,0,0,0,0,0,69,[nan]
d21,0,0,0,0,0,69,[nan]
d22,0,0,0,0,0,69,[nan]
d23,0,0,0,0,0,69,[nan]
d24,0,0,0,0,0,69,[nan]
d25,0,0,0,0,0,69,[nan]
d26,0,0,0,0,0,69,[nan]
d27,0,0,0,0,0,69,[nan]
d28,0,0,0,0,0,69,[nan]
d29,0,0,0,0,0,69,[nan]
d30,0,0,0,0,0,69,[nan]
d31,0,0,0,0,0,69,[nan]
d32,0,0,0,0,0,69,[nan]
d33,0,0,0,0,0,69,[nan]
d34,0,0,0,0,0,69,[nan]
d35,0,0,0,0,0,69,[nan]
d36,0,0,0,0,0,69,[nan]
d37,0,0,0,0,0,69,[nan]
d38,0,0,0,0,0,69,[nan]
d39,0,0,0,0,0,69,[nan]
d40,0,0,0,0,0,69,[nan]
d41,0,0,0,0,0,69,[nan]
d42,0,0,0,0,0,69,[nan]
d43,0,0,0,0,0,69,[nan]
d44,0,0,0,0,0,69,[nan]
d45,0,0,0,0,0,69,[nan]
d46,0,0,0,0,0,69,[nan]
d47,0,0,0,0,0,69,[nan]
d48,0,0,0,0,0,69,[nan]
d49,0,0,0,0,0,69,[nan]
d50,0,0,0,0,0,69,[nan]
master_item_no,0,0,0,0,0,69,[nan]
row_hash,69,69,0,0,0,0,"[2617736706, 3052633791, 1289519252, 1305443870, 2413461418, 1253999423, 1070497764, 1791655391, 2312404489, 3184885073, 2108784051, 2371256162, 3137961348, 481526049, 795574102, 489259695, 3038871421, 3322773732, 1017085503, 3092020783, 4189683800, 2071101495, 1141800837, 3335684979, 2107146250, 1690467377, 1916633285, 2189001597, 183796008, 3703603057, 4097998801, 1365672626, 2750841224, 1286766379, 780107635, 3833430105, 1261011304, 1978826532, 444824883, 3598548259, 4213538744, 2221835182, 1504018498, 2435612237, 3852697898, 2838920850, 704020322, 2049671978, 531333112, 3078192549, 922451428, 3949428921, 426671991, 2469691314, 1124433232, 3539565936, 3098640147, 1329626714, 2961080932, 3120070470, 483753849, 2991291647, 3679485193, 4152065719, 1746433522, 862090825, 52983602, 1736409133, 570785909]"
fecha_lote,69,24,45,0,0,0,"['2023-06-05', '2023-09-22', '2023-08-31', '2023-07-22', '2023-09-20', '2023-06-21', '2023-09-27', '2023-11-04', '2023-11-24', '2023-10-31', '2023-06-06', '2023-07-11', '2023-11-17', '2023-06-22', '2023-08-18', '2023-06-16', '2023-08-26', '2023-07-18', '2023-09-01', '2023-10-11', '2023-09-28', '2023-08-29', '2023-08-10', '2023-09-14']"
